####################
#........#.........#
#.###.##.#.##.###.#
#P.......G.........#
####################