####################
#........#.........#
#.###.##.#.##.###.#
#.................#
####################