####################
#........#........#
#.#.##.#.#.#.##.#.#
#o#....#...#....#o#
#.#.##.#.#.#.##.#.#
#........P........#
####################
