####################################
#P...........#............#........#
#.######.###.#.##########.#.#####..#
#......#.....#.....#......#....#...#
#.####.#.###.#####.#.#####.##.#.####
#.#....#.#.#.....#.#.....#....#....#
#.#.####.#.#####.#.#####.#.######..#
#.#......#.....#.#.....#.#.......#.#
#.###########.#.#####.#.#######.#..#
#.....#.......#.....#.#.....#...#..#
#.###.#.###########.#.#####.#.###..#
#...#...............#.....o.#......#
####################################
