####################
#........#.........#
#.####...#...####..#
#....#.......#.....#
#.##.#.#####.#.##..#
#P...#...#...#...o.#
#....###...###.....#
####################
