############################
#P.........#.........#.....#
#.####.###.#.###.###.#.###.#
#....#.....#.....#...#.....#
#.##.#.#########.#.###.###.#
#....#.....#.....#.....#...#
####.#####.#.#########.#.#.#
#....#.....#.....#.....#.#.#
#.##.#.#########.#.###.#.#.#
#....#...........#...o.....#
############################
